6/8/2024 - 11:58:5#//#User2#//#1234#//#-1
6/8/2024 - 11:58:14#//#User3#//#125#//#0
6/7/124 - 12:13:52#//#User2#//#1234#//#-1
6/8/2024 - 12:50:16#//#User2#//#1234#//#-1
8/8/2024 - 11:27:16#//#User2#//#1234#//#-1
8/8/2024 - 11:30:26#//#User2#//#1234#//#-1
8/8/2024 - 11:30:45#//#Abd#//#1234#//#58
8/8/2024 - 12:51:53#//#User2#//#1234#//#-1
12/8/2024 - 3:27:22#//#User2#//#1234#//#-1
12/8/2024 - 5:23:16#//#User2#//#1234#//#-1
12/8/2024 - 5:25:38#//#User2#//#1234#//#-1
12/8/2024 - 5:27:23#//#User2#//#1234#//#-1
12/8/2024 - 5:28:41#//#User2#//#1234#//#-1
12/8/2024 - 5:30:33#//#User2#//#1234#//#-1
12/8/2024 - 6:58:42#//#User2#//#3456#//#-1
17/8/2024 - 17:45:23#//#User2#//#3456#//#-1
17/8/2024 - 17:51:54#//#User2#//#3456#//#-1
17/8/2024 - 17:53:48#//#User2#//#3456#//#-1
18/8/2024 - 11:32:5#//#User2#//#3456#//#-1
18/8/2024 - 11:38:49#//#User2#//#3456#//#-1
18/8/2024 - 12:30:5#//#User2#//#3456#//#-1
18/8/2024 - 12:31:46#//#User2#//#3456#//#-1
18/8/2024 - 13:40:29#//#User2#//#3456#//#-1
18/8/2024 - 13:42:22#//#User2#//#3456#//#-1
18/8/2024 - 13:57:4#//#User2#//#3456#//#-1
18/8/2024 - 13:58:25#//#User2#//#3456#//#-1
18/8/2024 - 14:3:40#//#User2#//#3456#//#-1
18/8/2024 - 14:7:31#//#User2#//#3456#//#-1
20/8/2024 - 11:36:5#//#User2#//#3456#//#-1
20/8/2024 - 12:34:9#//#User2#//#3456#//#-1
20/8/2024 - 15:29:35#//#User2#//#3456#//#-1
28/8/2024 - 17:27:7#//#User2#//#3456#//#-1
27/2/2026 - 23:12:12#//#User1#//#1234#//#0
27/2/2026 - 23:33:1#//#User1#//#3456#//#0
27/2/2026 - 23:33:36#//#User2#//#3456#//#-1
